10 10
.#...#....
...#.#.##.
####..###.
....#..#..
.##..#...#
..##..##.#
#...#.#...
#.#.#..##.
...###....
.#....#.#.
