8 8
..###.#.
#..#....
..#..##.
.#..###.
...#....
###..#.#
.#..#...
...#..#.
