8 16
.#......#.......
..#.###.#.#####.
#..#..#.......#.
##.#.#..####.#..
##....##....#..#
..#.#..#.##..#..
.##.#.#..#.#.#.#
....#...##......
