16 16
..#####..#...#..
#...#...#..#.##.
.##.#.###.#.....
.##.#...#.##.##.
....#.#.#.#..#..
.####.#...#.####
.#..#.#####....#
.#.#..#....#.#.#
....##..##.#.#.#
###.#..#...##..#
.#..#.#..##...##
.#.#...#.#..#.##
.#..##.#...##.##
.##.....###....#
..######....##..
#........#.####.
