32 16
.#.###.#......#.
.#......#.###...
..##.##.#....###
#.##..#..#.#..#.
#.###..#..###...
..##.#..#.###.#.
.#...#.##..#..#.
.#.#.#.#.#..##..
...#.#.#..#..#.#
####...##..#.#..
.#..###...##.#.#
...##.#.#.##.#..
.#......#..#.##.
..######.#.#.#..
#..#...#...#.#.#
##...#.#.###.#..
#..##..#..#...#.
..#...###.#.#...
###.#.##..#.###.
...##...###....#
.#.#..#.....##..
.#..###########.
..#...#...#####.
#..##.#.#..#....
##...##..#...###
#..#.#.#..###...
#.#.....#.#...#.
..####.##..####.
.#...#...#..###.
.##.####..#..#..
.#..#####..#.#.#
...#######......
