32 32
....#......#.#....#........#.#..
###.#.##.#...#.##..#.###.#.#...#
.#..#..#.#.##..#.#...#..##.#.#..
.#.#..#..#...#.#..#.#.#....#.###
.#.#.#..####.#...##...#.#.#.....
...##..####..#.######..##.#.#.#.
.##...#.....###......#.#..####..
....##..##.###..##.#.#..#...##.#
#####.#...#.#..##..#..#..##....#
...#...##.#..##...#..###.#.###..
.#...#.#..##.#..#..#..##.#....#.
..##..##.#.....####.#....#.#.#..
.#..##...#.###...#....######...#
.#.#...###.#..##.#.#.#.....#.##.
.#.#.##.#..#.#.#..#.#..#.#.##...
...#.#..#.##...##...#.#..#....#.
##...#.#..##.#...#.#..#.######..
###.#....##...####...#.#.....#.#
##..#.####..##....##...#.###...#
#..#.....#.#...##.#.#.#..#####..
..######...#.##...#.#..#..#####.
.#...#..####.#..##....#.#...##..
.#.#.##......#.#...#.##..##..#.#
.#.#..#.#####..#.##.....##.#.###
...##.#..#....#...######...#...#
##..#...#..#.#..##.......#..##.#
####.###..#.#..#...######..#...#
###...##.##.#.###.#....#..#..#.#
###.##...#..#.##..#.#.#..#.#.#..
###..#.##..##..#.#..#..#.#...##.
####.#.#.#.#.###.#.#.###.###.#..
####.............#...........##.
