32 64
..#...#.....##....#....#.#...##.#...##...##...#...#.##........##
#..##...#.#....##...##...#.#.#....##...#....#...#.#....#.##.#..#
##...#.#..####...###...##..#...#.#...####.##.###..#.###..#.###..
#.##..##.#.....#..#..#..##.##.####.##..#..#....#.##.###.#...#.#.
..###..#..#####.#.###..#...#..#.......#..##.##.#.##.#...#.#.#.#.
.#...#..#........#...###.##..#..#####.#.#....#...#..#.##..#.#...
.#.#.#.#..####.##..#...#..#.#..####..#..#####..###.#..##.#..#.##
.##....#.#...#...#.###..#.#..#..##..#..#.....##...#..#...#.##.#.
....####...#.#.#...#..#...##..#.#..#..#..###.#..#...#..##..##.#.
.###....#.#..#..#.###..###..#.....##.#..#..#...###.#..###.##....
.....##..#..#.#..#.#..#....#..###.#...#...#.#.###..#.#....#..###
#####..#.#.#...##....##.#.###...##..#.###....#.#..##.#.#.##.#..#
....##...#..##....##...#...#.###...###...##.#..#.##...#..#...#..
.##....####..##.##..##...##....#.####..#......##.#..##..##.#..#.
.#.####..###.#..#..####.#...##.#......#..###.##..#.#.#.###.##...
...#..##..#....#.#.#...##.#.#..#.#.###..#...#...##...#..##...###
##..#...#...##.#...#.#....##..#...#...#.#.#.#.##.#.####....##...
.#.#..#.####...#.#.#..####...#.#.#..#..#..#.#..#.....#.#.##...#.
...###....#..#....#..#..#..##....#.#..##.#..#.##.#.#....#...#.#.
.##...###.#.#.####..#.#...#...####..#....#.##...##..###...#.##..
..#.#.##...#....##.#..#.###.##....#.###.##.#..#.##.#...###.#...#
#.#.#.#..#...##....#.##.#...#..##...#..#...###....#..#.#...#.##.
#.#.#...#####..#.###....#.####..####.#..##...#.##.#.##..##.#.##.
..#..###.#...#.##...#.#.#.#####....#.##...##.#.#.....#.#...#....
.###..#....#.#....#.#.##...###..##.#...##.#..#.##.###..#.##.###.
.####.#.##.#.#.###..#.#..#....##.#..#.#...#.##.#..#.#.#.....#...
..#...#...#..#.#.#.#..#####.#....#.##...#...#...###.#.#.#.#.#.##
#...##.##.#.#..#.#.#.#....##..#.#..###.#.#.#..#.##..#.#..#....#.
.###...#..#.#.##.#....#.#....#.##.###....#..##.#...#..##..#.##..
....##...#....#...###..#..###......#..##.##......#.#.#..#..#...#
.##..###.######.#.#..#.####...#####..##..#.######....##.#.#..#.#
...#............#...##......##......#...#.........##....#...#...
