64 64
...........###....#..###.#...#..#............#......#####...###.
##.##.#.###....##..#.....#.#..#.#.########.#.######...##..#..#..
...#####....###..#..##.##...#....##...#....#.......##....#.#.#.#
#.#......###...#..#.#.....######..#.#...##########...#.##....#.#
..#.#.####...#..#...#.####...####..###.#...#......#.#..#..#.#...
.##..#....#.#.#...#.#.#....#...###.....#.#...#.####..#..#.###.#.
....#..##.#.#..#####..#.##.#.#..###.#.##.#####.....#..#.##....#.
##.##.#...#..#...##..####..#..#....#..#.......#.##.#.#.....###..
..#....#.#..#..#....##....###.###.##.#.####.#..#.#.#.#.##.###..#
#.#.###..#.#..##.###...##.####...#...#.....###...#.#..##....#.#.
..#...#.#..#.#...#...###...##..#...####.##....##.#..#.#..##.#.#.
.#.##.#...#..#.##..#.###.##...######..#.#.#.#..#.##...#.###.#...
....#.#.##.###....#..###..#.#..#....#.#.#.#..#.#...#####...##.#.
.#.##..###....####.##...##...##..##...#.#..#.#..##...##..#...##.
.#...#..##.##.###.....#....#.#..#..#.#...#.#..#..###....#.##....
#..#.##.#..##.##..#.#..####.#..#.#....##...#.#.#....###.#...###.
..###...#.#...#..#..##.#......#....###..##..#...##.#...#..#.....
#.###.###..##.#.#..###.#.#.###..#.##...#...#..#.##.#.#..#..#.#.#
#..#..#..#.#..#.#.###..#.#...#.##....#.#.##..#..#..#.#.#..#.#...
.#.#.###...#.###..##..#.#..#..#..###..#..#..#..#..#..#..#.#..##.
.#.#..#..#.#..#..#.#.##.#.#.#.#.####.#..#..#.#..#.#.####..##..#.
.#..#..#.#.##...##...#..#.#.#....###..#...#....##......#.#..#..#
..#...#..#...###...##.#.....#.##.###.#####..###..##.#.##...###..
.##.##.##..#....####...#.##..###...#..####.#....#.#..#..#.#...#.
.#..#....####.##...#.#..#..#..#.##..#..##..#.#.#..##...##.#.#...
...##.##..#...##.#...##.#.###.#..##.###...####...###.#.#..##.#.#
.#..#...#...#..#..###...#.##..##..#..##.####...#..##..#..#......
#.#.#.#..##.###..##.#.##.....#.##..#....#....#..#...#...#..###.#
..#..##.#....#..#...#..#.#.##...##.###.#..#####..##.#.##..#....#
.#.#.#..#.###..#..#.##.###...##....#..#..#....#.#.#..#...#.#.#..
.....#.###...#...#...#....##..#.##..#...##.##..#..##..#.#...#.#.
#.###......#..#.#..#..###..##.#...#...##...#.#...####.#.#.#.....
..###.#.#.#..#..#.#.#...#.#...#.#..##..#.#.#.###..#...#..##.####
.#.#..#.####.###.....###..#.##.###.#..##.#.#...###..####..#.#...
....#.#...##.#...#.##....##.#...#..#.#..#..#.#...#.#.....##..##.
.##.#.###..#.#.#.#.#..#.#...###...#...#...##..##...#.#.###.#..#.
#....#...#.#..#...#..###.#.#...###..##.#.#...#.####...#.....#...
#.####.#.#..#...#.#.#.#..#.#.#.....#.....#.##.......#...#.##..##
#.#....#..#..#.#..#.#...#....######..#.#.#.#..#.#####.###..#.#..
#..#.##.#.##.##..#...#.#..#.#......###.#...#.####...#..#..##.##.
..#..#..#.#....####.##..#.##..###.#...#..###..#...#.##..#..#..#.
#...#..#...#.#....#...#....#.#..#...#.##.#...#..###...###.###.#.
.###..#.##.####.#..##.##.#.#..#..###..#..#.##..#....#......#..#.
...##......#...#.#.##...###..#..###.#..#..##..#.####.##.#.#..#..
##.#..##.##..#...#.####..#..#..###...#..#....#...#...#.#.#..#..#
...#.#..#...##.##..##..#...##.###..#..#.#.##.###...#.....#.#.#..
.#...##..#.#.....#...#.#####...#..####..##...#...#..#.###..#..#.
.#.#####.##..#.#.#.#....#....#...#.#...##..###.######..#..#.#...
.#.#...#.#..#..#....###..#.#.#.#...#.###..#....#.....#.#.##..#.#
.##..#....#.########..#.##..#...#.#..#..#.#.#.##.#.##..#..##....
...##..##.#.......##.#...#.#..#.#.#.#.#..#...#...#....#.#..#.##.
##.#.#..#...#.###..#...#...#.#.#..#.#.##...#..###..#.##..#.#.#..
.#.#..#..###.#...##..#####..#...#.#.#....###.#....##....#..#..#.
...##..#..#..#.#...#..##..##..#.#.#..#.##..#.#.#.#..#####.###.#.
#.####..#..#.#..##..#....#...##.#.##.#.#..##.#..#.#.#......##.#.
...##.#...#...#.#.#.####.##.##..#..#.#.#.#...##.#.....#.###...#.
##....#.#...##..#....#..#...#..###.#.#...#.##...##.#.#.#....##..
..###.#..##.#..#..##.##.#.###.#.#.##.##.#...####..#..#...#.##..#
.#.....#.##.#.##.###......#.#........#.##.##....#...#.##.#...#..
.##.###..##.#...#...##.####..#######.#....#..##...###...##.#..#.
.......##.#..##.#.#...#...#.#.......#..##.#.#..###....#...#..##.
#.####.....###..#.#.##..#...#.##.##...#.##..##...#.###.##.#.#...
.....#####.....#...#...#.##.#.##..####.....#...##..#.#......##.#
.#.#......#.#.#..#...#...#......#......#.#...#....#....#.#.#....
