128 64
.#...#.#......#.....##.#......#...#.......##.....##....##.......
.###.#...###.#..###......##.##..#...#####.#..###....##..#.#.##.#
...#...##....#.#..###.##.##..#.#..####.....##...#.##..#..#..#...
##.#.#..#.##.#...#....#..#####.##...##.####...#...#.#.##.#.##.#.
...#.####.#...####.####.#.#......##.##....#.######.......#...#..
.##.#...#.#.##.....#....#.#.#.###...###.#...#....#.######..#.###
.##...#...#.#..##.#.#.###.#.##....####...###..##.#.##.....#.....
....##.##.#..###..#...#...#..#.#.#...#.##....###.#..#.####..#.#.
####....##..#....#..###.#.##.#..##.#..#...##.#...##..#####.#..#.
.....##.#..#..##.#.#....#..#.##....##...##..#..##..#..###..#.#..
.#.##..#..##.#.##..#.#####.#..#.###.####..#.#.#.#.#.#..#..##..#.
.#....#..#...#..#.##.#..#...#..#.........#..#.#...#.##.#.#..##..
.###.##.#..####...#...#...#..#..####.###..#.#.#.##.....#..#..#.#
...#....##...#.#.#..##..#.##..#.#....#.##.#.#.#.#..####..#.#.#..
##.#####...#...#..##...#..#####.#.#.##..#...#.#...#....#...#..#.
##..#..#.##..#.##...#.##.#.#....###.#.#.#.#.#.#.##..##.###..#.#.
###..#..#.#.#..#.##.#.#....#.###....#.#..##.#.#...#..#....#.#.#.
#..#..#.#....#...#....#.###..#...###..##..#.#.#.#.##.####.....#.
..##.#..######.#.#.#####....#..##..#.#..#...#.##..###....######.
.##...#..##...##.#..#....###.#.#.#...##.#.#.#...#..#..##.#......
...#.#.#....#.#..#.#..#.#....#...#.#....#..#.##..#..#..#.#.#.###
##.#.#...#.##.#.#...#.##..#.##.#.#..##.###...#.#.##..#.#...#....
...#.#.##..#....#####...##......#..###....#.#..#...#....###.###.
.##..##...#..#.#.....##.##.#.###..#...###...#.#.#.###.##.......#
.#..#...#####.##.###.##....##....##.#.#.#.##..#...#....#.#####..
...#.#.##...#....#.#...#.##...###.#.##...#...##.##..#.#..#.....#
.##.......#.#.##....#.#.#...##....#....#...#..#.#..#.#..#..#.#..
..#####.##..#.#.##.##...#.##.#.#.#..####.##..##.#.#....#..#####.
#....#...#.##.#...#...##..#...#..#.##..#...#..#.#..#.###.#...#..
.###..####....#.#...#.#..#..#..#.#....#.##..#.#.##.#..#..#.#..#.
...#.#....###.#.#.#..#..#..#.#...####...#.#.###...#.#..#....#.#.
.#...#.##...#.#..####..#.#...#####...##...#....##....#.#.####.#.
..####...##.#..#.##...##...#.......#..#####.#.##.#.#.#..#.....#.
.#....##.#...#.#...##..#.#.####.##.#.#...#..#.#..#.####..#.###..
.#.##..#.#.##...##...#..#....#..#.##...#.#.#..#.##...#.#.#.#.##.
.#...#.#.#..#.#####.#.#..#.#..#.#..###.#..#..#....##.....#.....#
..##.###..#...#........#.#..###..#.#..#.#.##...#.########..###..
#..#....#.#.#.#.######.#.##....#.#.##...#.#.####.##......###..#.
.#.##.#...#.##..#......#..####.#.#.###.##.#..##..#..#.##....#.#.
.#...#.####..#.#..#######....#.#.#..#.....##....##.##...###.....
..##.......#.#.#####....####.#.#.##..#.#.#..##.#...##.#.#..#####
.#..######.#.#......###...##..##...#.##..#.#...#.##.#.#..#.#....
.##..#.....#.####.#.....#...#...##.#.#..#....#..#.....##.#...#.#
..##..####.#.....####.#.#.#.#.#.##.#..#.#.###..#..##.#...####...
#.###......##.###....##..#..#.#....##.....#...#..####..##....##.
#...#.#####..#....##..##.#.#..#####...#####.##..#.##..#...##....
#.#.#.#.....#..###..#.#.##...#...#.#.##...#...#.#....#..##..##.#
..#...#.#.##..#...#......#.##..#.#...##.#...##...#.###.#...#.#..
.#####.#..##.#..##.#####.#.#..#..######.#.##...#.#...#...#.#...#
..#..#...##...#.#..#.....##..#..#.....#.#..#.##.####..####.#.##.
#.##...#...##.#...#..#.#..#.#.#...###..###.#.#...#.#.#.....#....
..#.#.#..#..#..#.#.#..####..#.####...#...##..#.#...#...####.#.##
.##...#.###.##.#...##.##...#......##..##....##..#.########..#..#
...#.###.##..#..#.#......##.#.####...#..####.##.#.#....#...###..
##.#..#....#.##.#..####.#.#.#......###.#...#...#....##.#.#.##.#.
...##...##.#....##....##....#.##.###.....##..#...#.#.....#....#.
.##.##.#.#..####.#.##...#.#..#....#..##.#.#.####..#..####.###.#.
..#..#....#....#.#.####...##...##...#...#.#..#.#.#..###.#....##.
#..#..###.##.#.#....#..#.#..###..###.#.##..#...#..#.......###...
##..#.......#..####...#...#.###.##...#..#.#.##..#.#.#.####....##
#.#.#.#.##.#..#....###.##.#..#.....#..#.......#.#..###...#.###..
..#..#....#..#..##..#.....##...#.##.#..####.#.#..#.##..#.#.#.#.#
.##.#..###..##.#..#.#.##.#...##.#...##...##.##..##.#..#..#.#.#..
.#..##..#..#...##...#...##.#.##...#...##....##.#...#.#..#..#.##.
...#...#..#..##...##..#.##.#.#..####.#######...#.###.##.#.#.....
.##..#.#.#..#...####.#..##..##.#####.........###.#...##...###.#.
..#.#..#...#..##..#..##...#..#..##..#########....##.#..###....#.
#.#..######..#.##...#..##..###.#...##...#.....##.#..#.#...#.##..
..##..####..#...#.##..##.#.#.....##.#.#..##.#.#.#..#..###...#..#
#...#.###..#.##.#..#.#...#...####...#..#.#..#.#...###.....##..#.
.##.#.##..#.....##.#...#..###.....###.#..#.##.#.#..#..#.##.##...
..#..#...#..##.#...##.#.###...##.##.#..#...#..##.#.####......##.
.###.#.##..#.#..#.#...#...#.##.#.#...#..##..#.#..#.....#####..#.
..#..#...##...#.#..#.#..#..#...#.#.#...#.##..#..#.####.#.#..#.#.
#...#.#.#...#....#.#...###...#...#..####....#..#..#..#....#...#.
..##....#.#.####.#..#.#####.#.##.##.#..###.##.#..#..#####.##.#..
#.#####.#.##...##.#.#..#....#.#...#.##..........#.#..#..#....#.#
...#....#.#..#....#..#.#.####...#.#..##.#######...##...#.###.#..
.#...#.##...#.#.#.##.#.#.#....####.#...##.....###...##...#....#.
..#.###...#...#.##...#.#..####......##.#..#.#.#..##.#..##.###.#.
#..#.#..##.###...#.##...#......###.###...##.#...###.#.##...##..#
..#....###.....###...##.#.######.#...####..####..#..#.#..#...#..
.#..###########...##..#.###.......##....##..#.#.##.#..#.####..#.
.#.#####......#.#..#.#.....####.#...#.#...#...#..#..#....#...#..
##...###.####.#..#...#.#.#....#..##.#..###..#.##..#.###.##.##..#
...#..#..#..#..#..###.#..####...#.#..#.....##..##.#....#...#..#.
.####..#..#..#.##..#....#....##.#...#..#.###.#.##..###...#.#.#..
.#...#..#...##....#..#####.#..#..###..##.....#.###.#..#.###..#.#
##.#.##..##...####..#...#..#.#..#...###.###.##.##..##.#..#..#...
...#....#..##.#..#.##.#...##.#.##.#........#...##.#.#...#..#..#.
.#..##.#.#.#..##.#..#..###...#.#..####.###...#..#.#...##..####..
..#..##......##...#..#.#...##..#.#..#.#.#.##.##.#.####...##....#
#.##..#.#####.#.#..#.#..##..####..#.#......#..#.#.....#.#...##..
#..#.#..#...#.#.#.##..#...#......##...##.###.##..#.##.#.#.#####.
##.###.#..#.#...#.#.#.#.#..##.###.#.#..#.#.....#..#...#.#...###.
##.....#.##...###.....##.#...#.....###.#.#.#######..#.#.###..#..
#..####..####.#..#####....##...#.#..#.#..#...#.....###..####..##
#.#...#####...#.#...##.##...#.#...#.#.#.####.#.##.###..######...
#..##....#..##....#..#.#.##.#..###..#...####.#.#...#..#.###...#.
.#...#.#.#.#.#.###.#.#.#..#.##..##.#..#..##..#..##.#.##.....##..
..##...#.#.#.#...#...#.#.##.#.#..#.##..#...#.##..##....#####...#
#.#.###..#...#.#..#.#..#.##...##.#.###.#.#.#..#.#...###.....#.##
..#.....#.##.##..#.#..##...##..#.#.##..#..#..#..#.##.#..###.....
#...###.#......#.#...#...#...#..#..#..###.#.##.##..#.#.#..##.##.
..#.#..#..####...#.###.#..##..#...#.#..#..#..#.##.#....##...#.#.
.#.#..##.#....####....#..#.##..###...#.#.#..##.#..#.##..#.#...#.
.#...##..####.....###..#.....#.#...##...##.##..#.#...##..####.#.
.#.#.##.##...##.#..#..#.#.#.#..#.#.#..#....#..#..#.#.#.#....#...
.#.#.##..#.#...#.#.#.##..#...#...#..#.#.###..#..##.#.#..###..#.#
.##..####..###...#.#...#...###.#####...#..#.##.#...#..#...##..##
...#..#...#...##.#.#.#..#.##....##...##..##....###..#..##...#.##
##...#..##.##..#...#..#..##..###...##...#..#.##....#.#..#.#...##
..##...#......#..##..#..#...##...##.#.#...#..#..#.#...#.#..##.##
#...#####.####.#...##..#..#.#..##.....###.#.#..#...#.#..#.#.#..#
..#...##..##....##.#..#..###..#..#.###..#.##..#..#...#.#..#..#..
.##.#...#.#..#####.#.###.....#.#...#.#.##.##.#..#.####.#.#.#..#.
#...#.#...#.#......#.###.####...##.#...#..#..###.......#.#.##..#
#.###.#.#.#.#.##.###.#...#..#.#....##.#.#.#.#...###.####.....#..
#...#..#..#.#.#.#....#.#..#....#.##.......#...#.#...#...#.#.##.#
.######..#....#...###...#.#.##.#...##.####.##..#..#.#.#..##..#..
........#####...##...##..##...####..#.#......#.#.#.#...#...#...#
#.#####......###..##...#...#.#.....#..##.###.#.#.#.#.#.#.#..##..
#......##.###...#.#..#..##.#.#.#####.#...#...#.#.#....##..#...#.
..####.###....#...#.#..#.#.#.#.#.....#.##..#..#...###..###..##..
.##....###.###.##.##..##...##..###.#.#.##.####..#.#..##...#..#.#
.#..###.#..#.#....##.#...###..#...#..#.#..#....#...#..#.#...#...
.#.##...#.##...#.#...#.###...##.#.#.##.#.##.###..#.#.##.#####.#.
.#....#...#..#.#...#.......##...#......#....#...#.....#.......#.
