128 128
..#....#......###....#...#....##..#....#..#...##........#...##........##.......#..#..........##.#..#.......#....##..........##..
.#..##...#.##..#..#.#..#.##.#...#...##.#.#..#....###.##...##...#.#.###...#####..#...##.##.#.#....#.#.#####..#.#...#.#.#.###....#
..#...###....#.#.#....#.....###..#.#......#..#.###..#..#.#.#.##..#.....###....#.#.##..##..#.#.##.#........#....##.#..##...####.#
#.###...#.##..#..##.###.####..##..#######..#..##...#..##...#.#.#..#####...##.##.#..#.#...##.#..#..##.#####..##..#..#.#.##....#.#
#....##.#.#.#...#.#..#..#.###...#.#...####.##....#.#.#.#.#...#...#......#....#..##...#.##....#..#...#.....##...###.#...####.#..#
.###.#..##...###...#..##...#..#...#.#.####.#.###.#.#....#.####.##.#.###..####..#..#.##.#..#####..##...###.#..#####..###...#..##.
...#..#....#....##..#....#.#.#..###.#...........##.#.##.....#..#..#.#..#......#..#..##..#......#.#.###..#...#.....#..#..#..#....
#.#.#.####..###...#..#####.#.#.##...##.#.#.#.###...#..##.###..#..##..#.##.####..#..#..#.#.####...#...##..######.#..#.#.#.#..#.#.
....#.#...#..####...#.#....#..#...#.####..#....#.#####...#...###.#.#.#.#.#....#.#.##.##..#....######...#.........#.#......#..#..
.#.#..#.#..#..#.#####...###.#...##..#....#..###..#...#.##..#..#....#.......#.#..#..#.###..#.#...#..###...##.###.#.########.#..#.
.#.#.#...#.###.....##.#......##.#..#..####.#.#..##.#...#..###.#.###.#######....#..##..#..#..#.#.#.#..######....#...#.#.....##...
.#.#.#.#.#.....###..#.#.#.###..#..#..#....#..#.#...#.##..#.#..#.......#.....###..#..#.#.#..#..#.#...#....#..##...#...#.#.##.##.#
.###....#.#####.###..##.#.#...#..#..#..##...#....###.##.#...##..#.#.#...####....###.#.#..#.#.#...#.#..##.#.#.####.#.##.#........
....####..#.......##..#..##.#...####.#...##..#####.#.##..##....#..#####.#.##.######.#..#..#...##...#.#...#.#....#.#.#..########.
.##.#....#..#####...#..#.##.#.#.##...##.#..#.......#...#.#.##.#..#...#..#....#.###...#.##..##.####.#.#.#.#..###.....#.#........#
##..#.#.#..#.....##...#..#..#.#.#..#..#...#..####.####.#.....##.##.#..##..####.....#.#...#..#...###..#.####.#...###.#..#.#.###.#
...#..#...#.##.#.#.#.#..#.#.#..#..###...#.#.#...#....#..####.#..##..#....#.####.#.#.##.#..#.#.#..#..##....#..##.#...##...##....#
.##..#.###...#.#....#.#....##.#..###.##..#..#.#..###.##.#....#.#..#..#.##......##.......#.#.#..#..#.#.###.##..#.##.#..###...##..
.#..##.#...#.#..###.#.#.##...##.###....#.#.#...#...#....#.##.#..#..#..#.#.#.##...####.#####..##.#.#.....#...#.#..#...#..#.##..##
.#.#...#.##..##.#...#.#...##.....#..##..#..#.###.#..####..#.#.#..#..#.#.#.#.####..#.......##....#..#.#.#.##.#..#..##.#.##..##...
.#.#.###.#.#.##..##.#.#.#...####...##.#.#.#..#....#.#...#.#...##.##.#....##.....#.#.#.#.#..####.##..#....#...#..#.##.....#.#..#.
.#.#...#.#....##.#..#...#.#.....###...##..#.#..###..#.#.#..#.#.......###.#..##.##.#..##..#.#..#...#...####.#.##.#..##.####..###.
.#..##.#.#.##.#..#.##.#.#..#.###...#.###.#..#.#...#...#.##.#...######..#.#.###.#..##.#..#..#.#.##.#.##.....##....#..##....#.#...
.##.##.#..#...#.#..#...#..#.#....#.#..##..##..#.#.####...#..##..##...#...#.###.#.#...#.##.##....#..##..##.#...##.##....#.#..#.#.
.##....##.#.##..#.##.##..#....###...#...#..#.##.#.....##..#...#.#..#...##..##..#...##.#...#..#.#.#..#.##....####.#.#####.#.#..#.
.#.###....#.#..##...##..#..#.#...#.#..#..#...#..##.##...###.#.#..#..###...#...#####...#.##..#..#.##.#..#.#.#..#.....#....#..#.#.
......##.##...#..##..#.#..#..#.##..###.#.#.##..#..#..##.#...#..####...##.#..##......###.#.#..#....#..#..#...#..####..#.#..#..##.
.###.####..####.#..#..#.#..#.#..#.#......#..#.#..#..##..#.####...#.##...###..#.###.#....#..#..###..#.##.#.##.#..######..#.##.#..
...#..##..#.......#.#...##.##..##.#.####.#.#..##...##..#..#...##...####.#..#.#....##.####.###....#.#..#.#....##.###...#.#..#...#
.##.#....##.##.##...###..#...#.#..#.#..#.##..#...##...#..#..#.#..#..#...#.##.#.##....#....##.###..###..#.#.#....##..#...##.#.#..
.....#.#.##...#..##....#..##.#.#.##..#.#...#.#.###..##..#.#.#..#..#..#.#..#..#.#.##.#..##.....#.#....#.#...####..#.#.##..#.#..#.
##.#.#.#.#..#..#..###.###.#..#...#..##..##...#.....#.#.#..#..#..####...#.#..##.#...##.#..####...####.#.####....###....###...##..
.##..#.##..#.#..#...#..#..#.#.#.##.#...##.###..#.##......##.###...#..#.#...#.#.#.#.#....##...###.....#.#....##....#.#....##.#..#
....##...#.#..#..##..#.#.#..#.#.#..#.###...#..###...####..#..#.##..###..#.#.....#...#.#.#..#.###.#.#.#...########.#..###...#..##
#.#...##...##..#...#...#...#..#.##.#.....#.#.#.#..###...#.##.#...#....#...#.#.#.###..#....#..##...##..###...###...##.###.#.#.#.#
##.#.#..####.#..##..###.##.#.#..##..##.###.#....####..#.##...#.#.####.###..#.##....#..#####.#...##...#....#..#..#..#.##...#..#..
#..#...###...##..##.#.....#..#.##.#.#..#....#.#.#.#..##..#.#.#.#....#...#.#....#.#.##..#......##.#.#...##..#..#..#..#...##..#.#.
..#.##..##.#...#..#...###...#..#....##.#.###.#..#...#..#.#..#...##.####..##.##.###...#.#.#.#.##....#.##.#.#.#..##..#..###..#....
.#..#.#....#.#.##.##.#.#.##..#.#.##.##.##....#.##.##.#.#..#..##.##.....#.#..#..#..##.#.#..###...#####.#...#..#..#.###.#...#.###.
.##...#.###.#..#....##....##...#..#..#.##.##...#..##....#.##..#...##.#.#.#.##.#..##..#..#.###.##......#.####..#.#..##...###.....
..#.#..###..#.#..##....##.#######.###...#.#.#.#..###.#.##.###..##.#..###...#..##....#.#...##..#..######.#.#..#...#..#.##...#.##.
#.#..#.###.##.#.#.#.#.#.#..#....#...#.#...#..#.#..#..#....####...#..#...####.###.####...##...#..#...#...#...#..##.#.#.#..#...#..
..##.#..##....##....#.#...#..##...#.#.#.####...##.#.######.###.#..#.#.#......##......#.#...##.#.#.#.#.##.#.##.#...#.#.#.##.#.#.#
#....##..####...#.##..##.##.###.###..##...#..#..#.#..#...#..#..##.#.#..######...####..##.###..#...#.#..#....#.#.##..#.#...###...
..###..#..#..##..####..##......#...#.#.##..#.##....#.#.#..#...#...#..#.#....#.##....#..#.....##.##..#.#.###.#.#.#..#..###..#..#.
#....#..#..#...#.##..#.#..####...##..#...#.#.#..####....#.#.#.#.##..#....##.####.#.#.#..##.#..#..#.#......#.#...#.##.#...#..#..#
..##...###..##.#....#....#....#.#...#.##.#..##.#....###.#.#..#..#..#..###.#...##.#....#....#####.#...####...#####..#.#.#..#..#..
.#..#.#####.##..#.#.#####..##...#.###.....#....#.#.#...#..#.#..#..####....###...#####.###.#.....######...##.#.....##.#.###.#..#.
.#.##....#.....#.#..#....#.#####..#...#.#.####..#....#.#.##..#.##......##...###.##.......#..###..#...#.#.#..#.###..#.#.....#.#..
.#..#.##..##.#...#.##.##.#....#..#..##..#.#...##..####.#..##.#...#.#####..#...#....#.#.#..#.#..#...#..#...##..#..#.#.#.#.#.#.#.#
.##.#.#.#.#..####...#..#.#.###..#..#...#..#.#....##...###.#..#.#..##.....##.#.##.#####..#.#.#.#.#.###...#....#.#.#.#..#..#.#..#.
....#.#.#..##....##...#..#..##.#..##.##..#..#.#.#...#.#...#.##.##..#.###.#..#..##.....#.#...#.#...#..###.##.##....#.#.#.#####...
#####.#.##.##.##...###.#.#.#...#.#...##.#..#..#...###...##...#..##.#....#..#.#....###..#.###...###..#....#.#...##...#.#....###.#
#...#....#..#...##...#...##..##.#..##...####.###.##..###...#..#..#.####.#.#...#.#.#..#...#...#..#..#..##...#.##..#.#...#.#..#...
..#.####..#..##...##.#.##...#.....#...##....###.....#..#.##.##.###....#.#.#.#.#.###.#..#.#.##.#...#.#.#.##......#..#.##..#.#..#.
.###...#.#..#..##.##...#.##..##.#.#.####.##....##.##..#...#.#.....#.#.#.#.#..#....#..##..#.##..##...#...#.#######.##.#..#..#.#..
..##.#...#.#..#.#...###....#.#..#..#..##.#..##..#....#..##..#.#.#..#..##...#..###..#....#...#.####.##.##..#.....#..#...#.#.##..#
#....#####...#...##.#..###....#..#...#....###..#.###.#.#...#..##..##.#.#.#..#....#..#.#.#.#....###.......#..#.#..#..###..#...#.#
..###.....#.#.#.#.#...#...#.#..#.###...##.#...#....#.#.###.#.###.#...#...#.#.#.#..#..#...#..###...#######..#.##.#..####.#.##.#..
.#.#..###.#.#......##...#..#..#....#####.#..##..##.#.#.....#..#...##.#.#.#...#.##..#.#.#..##....#.........#.....#.####..#....##.
...#.###..#...####.#.###.#...#####.......#.#...####..###.#.#.#..#....#..#..##....##..#..#....###.#####.###..#####..##..#..###...
.###..#..###.#..#..#.#.#..###.....##.###.#...#..###.#....##...##.####.#.#.#...##.#..###..####....#...##...#.#....#....##.####.##
#...#.#.#....#.##.#.....#.....###.##..##..#.###.##..#.###.#.##.........##..#.#.#.#.#.#..#....#.##..#.#..#.#.#.##...#.#...###....
..#...#.#.##.#.#..#.#.#..#.#.#..#.#.#...#.#....#...##.#...#.#..###.#.#.#..#..#...#.#.#.##.##.#.##.#..#.##...#..####..#.#..#..###
.#.###..#..#.#.#.#..#..#.##..#.##.#...#..#.##.##.##...#.##..##....#..#..#.#.###.#..#...#...#.#....#.##...###.##.....#..##...#...
.#..#..#.#.#.#.#..###.##..#.##....###..##...#..#...#.#..##.#..##.##.###.#..###..#.#.###..##..##.###...##..##....###..#..#.##..#.
..#...#...#..#.##..##...#...#..###...#..#.#.#.#.##.#...##..#.###..#.###..#.##..#..#...#.###.#.#.#..#.#..#.#..#.######.#..#...#..
#..##..##...##..##.#.##..##.#.#....#..##..#.....#...#.##..#...#..#..#..#.#....###...#...##....#.##.#.##.#..#.#..#.....##...##.#.
.#.#.#.#..#...#.##.....#.#.#..#.##..#....###.#.#..####...#..#...#..#..#..####.##.##..###...#.#...#.#.#...#..#.#...##.#..#.##..#.
...#.#.#.#.##.#.#.####.#.#...##...#.####...#..##.##....##..#.#.#..#.#.#.#....#.....##....##.##.#...#...#..#.#.#.#..#..#..#.#.##.
.###....#.....#...##.#...###...####.....##..##...#..#.#..##...##.##...#...##...###...#.####...#####..#..###.#....#..#.##...#....
...#.##.#.#.#.#.#....####...##.#...#.##..##..#.##..#...#.##.#..#..#.#.#.#..##.####.#.#...#..#....###..#.....#.######..###.#..#.#
.#.####..#..##..####.#....#..#...#.#...#..##.#...##..##..##..#.##.#.#....#..##....##..##...#####....#######..#.....#.###..#.#.#.
.#...#.#...#...#.....#.#.#.#..###..#.#..#...#.##....#...#..#.#....##.#.#..##...##.#.#.###.###...#.#...##...#...###.#.##..#..#...
..##.#.##.##.##..##.###....#.#####.#.#.####.#.#.######.#..##..##.#....##.#...##.#.#.#..#...#..##..###..#.#..#.#......#..#.#.#.#.
#..#.#.....#..#.####.#..#.#....#...#.#..#.#.#...######.#.#..#..#.#.##.#..#.##...#.#..#..##...##..#...##..##.#.####.#...##...##..
..##..##.##.#..#.##...##..#.##.#.#.#.##.#.#.#.#..####..#...###..#..#..##.#.#..#...##..#..#.##...#..#....#...##....######..##...#
.#..#...##...#......#....##...##..#...#.#....#.#..##..#..##.##.#..#.#...##..#.#.##.##.##..#...#..#.######.##...##..#.....#...###
...##.#..#.#.#.#####.####.###...#..##.#..###....#.#..#.#.....#.#.##..##...#.#..#....#...#.#.#..#.#....###.#..##.#.##.####.#.##..
##...#.#.#.##..#.....##......##.##..##.#....#.#.#...#..#####...#...#..###.#..#..#.#...#.#.#..########...#...#...#....#....#...#.
...#...#.#..#.#.####.##.##.#..#...#.....###.#.#.#.#..#...#.#.#..##.##...#.##..#..#####..#..#.#.......##.#.#.#.#..####..###..#...
.#..#.#..##.#......#.....####..##..####...#..##...##..##...#..#.##..#.#.#....#.#..#.#..#..#..#.##.###.#.#.##..#.#.....###..###.#
.#####..#....#####.#####.....#..#.##...##..#.#.###..#..###.#.##...#.#.#..#.###..#.#...#.#.#.##..#.....#.##...##.#.###.##..#.##..
#...#..#.#.#######.....####.###.#..#.#..##...#.....###..##.#.#.##.#...##.#.#.#.##.#.##..#.#..#.##.##.#..#..##....#.#..#..#...##.
#.#...#......###..##.#.....#....##...##...###..####.#.#......#..#.####....#....#..#....#..##.#...###.#.#..###.##.....#..#..#....
#..#.#..####..#..#..###.#.#..##.#..##..##.....#..#....#.###.###...#..#.###..##.#.#.#.#...#...###..#..#..#.###...#.###..####.#.#.
#.###..##...#...#..#...#....#...#.#...#####.##.#...##..#...#.#..#...#....#.##..#.#..##.#...##...#.#.###.#.####.##....#..#...#.#.
...#..#...#..##...##.#...##..####.#.#.#...#....##.#.##...#.#.#.#.###.###.#..#.##..#.....#.#...#...#.##..#..###...###..#.#.#...#.
.##..#..##.#...#.##...#.###.#.......#.#.#..#.#....#...#.##.#.....##...##..#.#.#..#..###..#..##.##.#....#.#..#.##.#...#..#..#.#..
.#..#..#.....#...#..#..#...#..#.#####...##.#.#####..#..#....#.###...#....#..#.#.##.#...#.#.#.....######..##.#.#..#.##..#..###..#
..##..#.##.#.###..#..##..#..####....#.###..#.#....#.#.#..####.#.#.#..#####.#..#...#..#...#...#.#..#.....###...##..##..##.#.#..#.
#..#.#....##..###..#..#.#.#....#.##.##...#.#.#.##.#.#...###...#.#..##......#.#.##..#..###.###.##.#..######.##.###....#...#...##.
.#.#...##.####...####.#.#..###...#..#..#..##.#..#.##..#.#...##..##...#.#####...###.###......#....#.#.......##..#.#.###.##..##.#.
.#.##.###..#...#...#..#..#....##.#.#..#.#.....#.#.#..###..#####...##.#..#..#.#..#.....###.##..###....##.###..#.#.#.#...##.#.....
...#..##.#...##.##...#.#..#.#...#..#.#..#.#.#...#.######.#..#..#.###..#...##..#.#.#.#.....#..#..#.##..#....#......##.#.#....##.#
#.##.#...#.###...###.#..#..#..#..#.#...##.##.###.....##..#.#..#..###.##.##..#.#.#.##.#.#.##.#..##...##.###.#.##.##...##..###.#..
..#....##..#...#....#.#..#..#.##.#..####..#.....##.#...#....#...####...#...#..#..#.....#.#..##.#.##.#..#...#.#.#...##.#.#....#.#
.#..##.##.##.#..####....###..#....#.....##..#.#...#..#.#.##...###...##...#...#..##.###.#.#.#.#...#..#.#..#.#...#.#.#...#..####..
..###..#..#..###.....##.####...#.######....###.##.#.#..#..#.##....#...#.#..#.#.#.#..###..#.#...#.#.#..#.###.##.#..#..#...#.#...#
#....#.#.#..#....####.#..##.####..#....####.......##..###..#...###.##..#..#.##.#.#.#....#..#.#.#.#.##.#..#...#.##.###..##..#.##.
..##.#.#.##...###...#..#....#...#.#.##.#..#.######...###..#..##..#.##.##.#...#...#.#.###..#...##.#.....#...###.##.#...#...#..#..
#..#..##...#.##...#...###.#..##.#.#..#.#.#..####...###...##.####...##....###..###..#.#...##.#.#...####.#.#.#...#..#.#.##.#..#.#.
##..#.#.##.#.#..#..###.....#....#..#.#.#..#....#.#.#...##.#.####.#...####..##.#...##.#.##....#..##...#.#..##.##..####.....#...#.
##.#..#..#.#.##.#.###..###..######...#.##.####..#..#.##...#..#...###.#...#....#.##...#.#..##.##...#.#...#.....#.#...#.#.#..##.#.
#..#.#.#...#..#.##....#...#..#########..#.....#.#.#..#.#.###...##..#.#.##..#.#..#..###..#..#...##.#.#.#..#####..#.#..#...#.#..#.
..#....#.####.#....###..#..##...#...#..###.#.##.#...#..#.######...##.#....#..##.##..###..##..#..#...#.#.#......#..##.#.#.#.#.#..
###.#.##..###.#.#.##..#..#..#.#...#.#.#..#.#..#..#.###.#..##....#.##..##.##.#...#.#..#.#...#..#..##....#..#.#.#.#..#.####..#..#.
...##...#..##.#.##...#.#..#...##.#.#...#....##.#.#.##...#....#.##..##...#...##.##..#.#.###..#..#.###.##..###.#...#.#....#.###...
.#....##.#....#....#.#...#.###.#...#.#.#.###.....#....#...#####..#.####...#.#..###...#...##..#..#.....#.#......#.#..###...#####.
.###.#...##.#.########.##..#....#.#..#...#...###..##.###.#.#....#..##..##..#..#####.#..#.###..##..#.#.#.#.###.#..##...###..##...
...#.#.#.###..#....#...#..#..####..#.####..##...#...#...#...#.#..#..#.#...##.#...#..###..##.#...#.####..#.#..#..###.#..#.##...##
.#.#.#.#..#..#..###..##.#...#...##.#..#...#...##.##.#.#.#.#.####...#..#.##...#.#..#.....#...###..#.....#..#.##.###...#...#..##..
##..#...#..####...#.#....#.##.#....##.#.##..##...###..#.#.#...#..##..#...#.##..##.#####...##....#..###.##.#..#..#..##..#..#.#..#
...#..#..#...#..#.#.#.##...##..#.#.#..#....#...#..#..##....##..###..#..#.#...#..#.#....###...###.#.#..#....#.##..####.###.#...##
.##..##.####.#.##...#..####...#..#..#..###...##..#..#..###...#..#..###..#.##.#.#...#.#...#.##.#....#.##.##.#...#.#...#.....#.###
....###..#...#.#.###.#...#..####..##.#.#..###...##.#..#..####..#..##..#.#....#.#.#..#..###.....#.#.#....#...##.#...#.##.##.#...#
.########..##....#....##.#.##...##.....#.####.#.#....#..#...#.#..#...#..#.##.#.#..#...#...####...##..###.##.#...##.#....#..###..
....###...#...#.#..##.#..#....#..#.####...###..#..####.#..#.#.#.#..#.#.##..#.#.#.###.#..#...#.#.#...#..#..#.#.#..##.####.#....#.
###..#..#...####..##..#.#.#.##..#..#....#....#...#...#.#.#....#...#..#...#..#..#..#...##..#.#..#..###.#.#.#..###....#....##.##..
...#..##.###.....#...#....#.#..#..#..#.#.###..######.#...#.##...#####.#.#.#...###..##....#...#..#..#....#.##....#.#...##..#..#.#
.##.#.#....#.#.##.#.#..##.#.#.##.##.##.....#.#...#....####...####.....#...##.#####..#####..#.##..#...##.#.###.#..#..#####...#..#
.#..#...##..#..#..#..##...#.##.#..#.#..###.#...#.#.##.#...##......#.#.###.#.#######.....#.#....#..#####.#.###..#..##...#.###..#.
...#####..#.##.#.#.#...##.#......##..##...#..##..#..#...#.#..#.##..#....#.#....#...####..##.##..#..###..#.##.#..##...#.......##.
.#..#...#...#..#...#.#..#.######.#..#...#.##.##.#.#..##.#..##..#.#.#.####..#.#...#.#...#.##...#..#.##..#.....#.###.##.######.#..
..##..#...###.###.#..#.#........#..#..##..##.#..#..#..#..#....#.....#....#..###.#..###.#..#.####...##.#..##.##..#..#..#.....##.#
#....#.#.##...##...###.######.#.#.#..#..#.##..#..#.#.#.###########.#..##..#.##...#...#..#..#...####...#####.#.#.#.##.#..#.##....
#.###...#...##.#.#..#.....#...#.###.###.....#.#.##.#.#...#...##...##.#.##.....##..##..#.#.#..#....#.##...#..#.#.#.....###.#..##.
#.....#...#..#....#...#.#...##......####.##...#....#...#...#....#....#....###....####...#...#####......#...#......#.#.......###.
